region_code,region_name,total_population,male_population,female_population,region_type,bundesland
01,Schleswig-Holstein,2953270,1443269,1510001,bundesland,Schleswig-Holstein
01001,Flensburg,92550,45874,46676,kreis,Schleswig-Holstein
01002,Kiel,247717,120149,127568,kreis,Schleswig-Holstein
01003,Lübeck,218095,104723,113372,kreis,Schleswig-Holstein
01004,Neumünster,79502,39256,40246,kreis,Schleswig-Holstein
01051,Dithmarschen,135252,66561,68691,kreis,Schleswig-Holstein
01053,HerzogtumLauenburg,203712,99689,104023,kreis,Schleswig-Holstein
01054,Nordfriesland,169043,82669,86374,kreis,Schleswig-Holstein
01055,Ostholstein,203606,97822,105784,kreis,Schleswig-Holstein
01056,Pinneberg,322130,157663,164467,kreis,Schleswig-Holstein
01057,Plön,131266,63357,67909,kreis,Schleswig-Holstein
01058,Rendsburg-Eckernförde,278979,137154,141825,kreis,Schleswig-Holstein
01059,Schleswig-Flensburg,206038,101614,104424,kreis,Schleswig-Holstein
01060,Segeberg,284988,140654,144334,kreis,Schleswig-Holstein
01061,Steinburg,132419,65268,67151,kreis,Schleswig-Holstein
01062,Stormarn,247973,120816,127157,kreis,Schleswig-Holstein
02,Hamburg,1892122,925616,966506,bundesland,Hamburg
03,Niedersachsen,8140242,4009822,4130420,bundesland,Niedersachsen
031,Braunschweig,1610865,796058,814807,statistischeregion,Niedersachsen
03101,Braunschweig,251804,124770,127034,kreis,Niedersachsen
03102,Salzgitter,104548,51829,52719,kreis,Niedersachsen
03103,Wolfsburg,125961,62441,63520,kreis,Niedersachsen
03151,Gifhorn,180232,89675,90557,kreis,Niedersachsen
03153,Goslar,134672,66690,67982,kreis,Niedersachsen
03154,Helmstedt,92470,45648,46822,kreis,Niedersachsen
03155,Northeim,133258,65576,67682,kreis,Niedersachsen
03157,Peine,138931,68750,70181,kreis,Niedersachsen
03158,Wolfenbüttel,120531,59652,60879,kreis,Niedersachsen
03159,Göttingen,328458,161027,167431,kreis,Niedersachsen
032,Hannover,2180058,1067013,1113045,statistischeregion,Niedersachsen
03241,RegionHannover,1173891,573513,600378,kreis,Niedersachsen
03241001,Hannover,545045,266093,278952,landeshauptstadt,Niedersachsen
03251,Diepholz,222816,110415,112401,kreis,Niedersachsen
03252,Hameln-Pyrmont,150640,72781,77859,kreis,Niedersachsen
03254,Hildesheim,278371,135757,142614,kreis,Niedersachsen
03255,Holzminden,70911,35112,35799,kreis,Niedersachsen
03256,Nienburg(Weser),123469,61060,62409,kreis,Niedersachsen
03257,Schaumburg,159960,78375,81585,kreis,Niedersachsen
033,Lüneburg,1757157,864122,893035,statistischeregion,Niedersachsen
03351,Celle,181994,89138,92856,kreis,Niedersachsen
03352,Cuxhaven,201413,98150,103263,kreis,Niedersachsen
03353,Harburg,261890,128854,133036,kreis,Niedersachsen
03354,Lüchow-Dannenberg,49178,23981,25197,kreis,Niedersachsen
03355,Lüneburg,187552,91180,96372,kreis,Niedersachsen
03356,Osterholz,116551,56813,59738,kreis,Niedersachsen
03357,Rotenburg(Wümme),167604,83960,83644,kreis,Niedersachsen
03358,Heidekreis,145394,72697,72697,kreis,Niedersachsen
03359,Stade,210306,104302,106004,kreis,Niedersachsen
03360,Uelzen,94362,45906,48456,kreis,Niedersachsen
03361,Verden,140913,69141,71772,kreis,Niedersachsen
034,Weser-Ems,2592162,1282629,1309533,statistischeregion,Niedersachsen
03401,Delmenhorst,78385,38557,39828,kreis,Niedersachsen
03402,Emden,50535,25071,25464,kreis,Niedersachsen
03403,Oldenburg(Oldenburg),172830,82742,90088,kreis,Niedersachsen
03404,Osnabrück,167366,80755,86611,kreis,Niedersachsen
03405,Wilhelmshaven,76089,37268,38821,kreis,Niedersachsen
03451,Ammerland,128253,62498,65755,kreis,Niedersachsen
03452,Aurich,192072,94234,97838,kreis,Niedersachsen
03453,Cloppenburg,177701,89720,87981,kreis,Niedersachsen
03454,Emsland,338052,171160,166892,kreis,Niedersachsen
03455,Friesland,100277,48749,51528,kreis,Niedersachsen
03456,GrafschaftBentheim,141269,70508,70761,kreis,Niedersachsen
03457,Leer,174348,86640,87708,kreis,Niedersachsen
03458,Oldenburg,133913,66240,67673,kreis,Niedersachsen
03459,Osnabrück,366221,181603,184618,kreis,Niedersachsen
03460,Vechta,146924,73728,73196,kreis,Niedersachsen
03461,Wesermarsch,89568,44652,44916,kreis,Niedersachsen
03462,Wittmund,58359,28504,29855,kreis,Niedersachsen
04,Bremen,684864,338233,346631,bundesland,Bremen
04011,Bremen,569396,280842,288554,kreis,Bremen
04012,Bremerhaven,115468,57391,58077,kreis,Bremen
05,Nordrhein-Westfalen,18139116,8890200,9248916,bundesland,Nordrhein-Westfalen
051,Düsseldorf,5261157,2565963,2695194,regierungsbezirk,Nordrhein-Westfalen
05111,Düsseldorf,629047,303510,325537,kreis,Nordrhein-Westfalen
05112,Duisburg,502211,247892,254319,kreis,Nordrhein-Westfalen
05113,Essen,584580,284152,300428,kreis,Nordrhein-Westfalen
05114,Krefeld,228426,111189,117237,kreis,Nordrhein-Westfalen
05116,Mönchengladbach,268465,132961,135504,kreis,Nordrhein-Westfalen
05117,MülheimanderRuhr,172404,83069,89335,kreis,Nordrhein-Westfalen
05119,Oberhausen,210824,102910,107914,kreis,Nordrhein-Westfalen
05120,Remscheid,112613,55709,56904,kreis,Nordrhein-Westfalen
05122,Solingen,160643,78038,82605,kreis,Nordrhein-Westfalen
05124,Wuppertal,358876,175788,183088,kreis,Nordrhein-Westfalen
05154,Kleve,319290,158966,160324,kreis,Nordrhein-Westfalen
05158,Mettmann,489794,236563,253231,kreis,Nordrhein-Westfalen
05162,Rhein-KreisNeuss,457264,221712,235552,kreis,Nordrhein-Westfalen
05166,Viersen,300882,146635,154247,kreis,Nordrhein-Westfalen
05170,Wesel,465838,226869,238969,kreis,Nordrhein-Westfalen
053,Köln,4527594,2216694,2310900,regierungsbezirk,Nordrhein-Westfalen
05314,Bonn,336465,160769,175696,kreis,Nordrhein-Westfalen
05315,Köln,1084831,526588,558243,kreis,Nordrhein-Westfalen
05316,Leverkusen,165748,80681,85067,kreis,Nordrhein-Westfalen
05334,StädteregionAachen,562559,283670,278889,kreis,Nordrhein-Westfalen
05334002,Aachen,252136,131493,120643,kreis,Nordrhein-Westfalen
05358,Düren,270833,134058,136775,kreis,Nordrhein-Westfalen
05362,Rhein-Erft-Kreis,478126,232974,245152,kreis,Nordrhein-Westfalen
05366,Euskirchen,197247,97449,99798,kreis,Nordrhein-Westfalen
05370,Heinsberg,261833,129489,132344,kreis,Nordrhein-Westfalen
05374,OberbergischerKreis,275404,135188,140216,kreis,Nordrhein-Westfalen
05378,Rheinisch-BergischerKreis,286213,138313,147900,kreis,Nordrhein-Westfalen
05382,Rhein-Sieg-Kreis,608335,297515,310820,kreis,Nordrhein-Westfalen
055,Münster,2664280,1309671,1354609,regierungsbezirk,Nordrhein-Westfalen
05512,Bottrop,118113,57364,60749,kreis,Nordrhein-Westfalen
05513,Gelsenkirchen,263000,130545,132455,kreis,Nordrhein-Westfalen
05515,Münster,320946,153935,167011,kreis,Nordrhein-Westfalen
05554,Borken,379070,189377,189693,kreis,Nordrhein-Westfalen
05558,Coesfeld,224692,110765,113927,kreis,Nordrhein-Westfalen
05562,Recklinghausen,619732,301126,318606,kreis,Nordrhein-Westfalen
05566,Steinfurt,456464,227186,229278,kreis,Nordrhein-Westfalen
05570,Warendorf,282263,139373,142890,kreis,Nordrhein-Westfalen
057,Detmold,2085331,1028145,1057186,regierungsbezirk,Nordrhein-Westfalen
05711,Bielefeld,338332,163149,175183,kreis,Nordrhein-Westfalen
05754,Gütersloh,371309,184955,186354,kreis,Nordrhein-Westfalen
05758,Herford,253551,124664,128887,kreis,Nordrhein-Westfalen
05762,Höxter,141819,70597,71222,kreis,Nordrhein-Westfalen
05766,Lippe,350588,171767,178821,kreis,Nordrhein-Westfalen
05770,Minden-Lübbecke,315974,156058,159916,kreis,Nordrhein-Westfalen
05774,Paderborn,313758,156955,156803,kreis,Nordrhein-Westfalen
059,Arnsberg,3600754,1769727,1831027,regierungsbezirk,Nordrhein-Westfalen
05911,Bochum,365742,178377,187365,kreis,Nordrhein-Westfalen
05913,Dortmund,593317,290847,302470,kreis,Nordrhein-Westfalen
05914,Hagen,189783,92810,96973,kreis,Nordrhein-Westfalen
05915,Hamm,180849,89104,91745,kreis,Nordrhein-Westfalen
05916,Herne,157368,77053,80315,kreis,Nordrhein-Westfalen
05954,Ennepe-Ruhr-Kreis,325193,157717,167476,kreis,Nordrhein-Westfalen
05958,Hochsauerlandkreis,261647,130454,131193,kreis,Nordrhein-Westfalen
05962,MärkischerKreis,410346,201533,208813,kreis,Nordrhein-Westfalen
05966,Olpe,134439,67321,67118,kreis,Nordrhein-Westfalen
05970,Siegen-Wittgenstein,277136,137437,139699,kreis,Nordrhein-Westfalen
05974,Soest,306068,152175,153893,kreis,Nordrhein-Westfalen
05978,Unna,398866,194899,203967,kreis,Nordrhein-Westfalen
06,Hessen,6391360,3151158,3240202,bundesland,Hessen
064,Darmstadt,4088107,2013342,2074765,regierungsbezirk,Hessen
06411,Darmstadt,162243,82530,79713,kreis,Hessen
06412,FrankfurtamMain,773068,380566,392502,kreis,Hessen
06413,OffenbachamMain,134170,66650,67520,kreis,Hessen
06414,Wiesbaden,283083,135153,147930,kreis,Hessen
06431,Bergstraße,275205,135926,139279,kreis,Hessen
06432,Darmstadt-Dieburg,300658,148978,151680,kreis,Hessen
06433,Groß-Gerau,280308,140349,139959,kreis,Hessen
06434,Hochtaunuskreis,239488,115782,123706,kreis,Hessen
06435,Main-Kinzig-Kreis,430838,212330,218508,kreis,Hessen
06436,Main-Taunus-Kreis,242420,118745,123675,kreis,Hessen
06437,Odenwaldkreis,97577,48156,49421,kreis,Hessen
06438,Offenbach,362137,178293,183844,kreis,Hessen
06439,Rheingau-Taunus-Kreis,189614,92814,96800,kreis,Hessen
06440,Wetteraukreis,317298,157070,160228,kreis,Hessen
065,Gießen,1067354,525963,541391,regierungsbezirk,Hessen
06531,Gießen,278664,136879,141785,kreis,Hessen
06532,Lahn-Dill-Kreis,257289,126692,130597,kreis,Hessen
06533,Limburg-Weilburg,174884,86675,88209,kreis,Hessen
06534,Marburg-Biedenkopf,249684,122463,127221,kreis,Hessen
06535,Vogelsbergkreis,106833,53254,53579,kreis,Hessen
066,Kassel,1235899,611853,624046,regierungsbezirk,Hessen
06611,Kassel,204202,99986,104216,kreis,Hessen
06631,Fulda,227456,113060,114396,kreis,Hessen
06632,Hersfeld-Rotenburg,121566,60827,60739,kreis,Hessen
06633,Kassel,240718,117984,122734,kreis,Hessen
06634,Schwalm-Eder-Kreis,182595,91370,91225,kreis,Hessen
06635,Waldeck-Frankenberg,159154,79226,79928,kreis,Hessen
06636,Werra-Meißner-Kreis,100208,49400,50808,kreis,Hessen
07,Rheinland-Pfalz,4159150,2054254,2104896,bundesland,Rheinland-Pfalz
071,Koblenz,1522508,751360,771148,statistischeregion,Rheinland-Pfalz
07111,Koblenz,115268,56506,58762,kreis,Rheinland-Pfalz
07131,Ahrweiler,128161,63413,64748,kreis,Rheinland-Pfalz
07132,Altenkirchen(Westerwald),131467,64960,66507,kreis,Rheinland-Pfalz
07133,BadKreuznach,161307,78730,82577,kreis,Rheinland-Pfalz
07134,Birkenfeld,81760,40508,41252,kreis,Rheinland-Pfalz
07135,Cochem-Zell,62666,31329,31337,kreis,Rheinland-Pfalz
07137,Mayen-Koblenz,218210,107696,110514,kreis,Rheinland-Pfalz
07138,Neuwied,187440,92274,95166,kreis,Rheinland-Pfalz
07140,Rhein-Hunsrück-Kreis,105566,52384,53182,kreis,Rheinland-Pfalz
07141,Rhein-Lahn-Kreis,124381,61390,62991,kreis,Rheinland-Pfalz
07143,Westerwaldkreis,206282,102170,104112,kreis,Rheinland-Pfalz
072,Trier,546565,272767,273798,statistischeregion,Rheinland-Pfalz
07211,Trier,112195,55489,56706,kreis,Rheinland-Pfalz
07231,Bernkastel-Wittlich,115099,57453,57646,kreis,Rheinland-Pfalz
07232,EifelkreisBitburg-Prüm,103642,52202,51440,kreis,Rheinland-Pfalz
07233,Vulkaneifel,61769,30928,30841,kreis,Rheinland-Pfalz
07235,Trier-Saarburg,153860,76695,77165,kreis,Rheinland-Pfalz
073,Rheinhessen-Pfalz,2090077,1030127,1059950,statistischeregion,Rheinland-Pfalz
07311,Frankenthal(Pfalz),49051,23923,25128,kreis,Rheinland-Pfalz
07312,Kaiserslautern,101228,50948,50280,kreis,Rheinland-Pfalz
07313,LandauinderPfalz,47610,22627,24983,kreis,Rheinland-Pfalz
07314,LudwigshafenamRhein,174265,87539,86726,kreis,Rheinland-Pfalz
07315,Mainz,220552,107358,113194,kreis,Rheinland-Pfalz
07316,NeustadtanderWeinstraße,53981,26306,27675,kreis,Rheinland-Pfalz
07317,Pirmasens,40682,19921,20761,kreis,Rheinland-Pfalz
07318,Speyer,51368,25130,26238,kreis,Rheinland-Pfalz
07319,Worms,84646,41957,42689,kreis,Rheinland-Pfalz
07320,Zweibrücken,34534,17075,17459,kreis,Rheinland-Pfalz
07331,Alzey-Worms,132536,65697,66839,kreis,Rheinland-Pfalz
07332,BadDürkheim,134546,65716,68830,kreis,Rheinland-Pfalz
07333,Donnersbergkreis,76208,37684,38524,kreis,Rheinland-Pfalz
07334,Germersheim,130793,64990,65803,kreis,Rheinland-Pfalz
07335,Kaiserslautern,108216,53113,55103,kreis,Rheinland-Pfalz
07336,Kusel,71462,35694,35768,kreis,Rheinland-Pfalz
07337,SüdlicheWeinstraße,112631,55379,57252,kreis,Rheinland-Pfalz
07338,Rhein-Pfalz-Kreis,155921,76581,79340,kreis,Rheinland-Pfalz
07339,Mainz-Bingen,214948,105745,109203,kreis,Rheinland-Pfalz
07340,Südwestpfalz,94899,46744,48155,kreis,Rheinland-Pfalz
08,Baden-Württemberg,11280257,5595424,5684833,bundesland,Baden-Württemberg
081,Stuttgart,4205849,2093955,2111894,regierungsbezirk,Baden-Württemberg
08111,Stuttgart,632865,315634,317231,kreis,Baden-Württemberg
08115,Böblingen,398528,197762,200766,kreis,Baden-Württemberg
08116,Esslingen,540226,269180,271046,kreis,Baden-Württemberg
08117,Göppingen,261857,130139,131718,kreis,Baden-Württemberg
08118,Ludwigsburg,551051,272828,278223,kreis,Baden-Württemberg
08119,Rems-Murr-Kreis,432397,213396,219001,kreis,Baden-Württemberg
08121,Heilbronn,128334,64610,63724,kreis,Baden-Württemberg
08125,Heilbronn,353283,177094,176189,kreis,Baden-Württemberg
08126,Hohenlohekreis,115063,57914,57149,kreis,Baden-Württemberg
08127,SchwäbischHall,202834,101772,101062,kreis,Baden-Württemberg
08128,Main-Tauber-Kreis,134745,67267,67478,kreis,Baden-Württemberg
08135,Heidenheim,135035,67292,67743,kreis,Baden-Württemberg
08136,Ostalbkreis,319631,159067,160564,kreis,Baden-Württemberg
082,Karlsruhe,2848400,1413296,1435104,regierungsbezirk,Baden-Württemberg
08211,Baden-Baden,57025,27240,29785,kreis,Baden-Württemberg
08212,Karlsruhe,308707,157553,151154,kreis,Baden-Württemberg
08215,Karlsruhe,454613,226144,228469,kreis,Baden-Württemberg
08216,Rastatt,234981,116683,118298,kreis,Baden-Württemberg
08221,Heidelberg,162273,77561,84712,kreis,Baden-Württemberg
08222,Mannheim,315554,157130,158424,kreis,Baden-Württemberg
08225,Neckar-Odenwald-Kreis,145493,72949,72544,kreis,Baden-Württemberg
08226,Rhein-Neckar-Kreis,555352,272531,282821,kreis,Baden-Württemberg
08231,Pforzheim,127849,62926,64923,kreis,Baden-Württemberg
08235,Calw,162853,81700,81153,kreis,Baden-Württemberg
08236,Enzkreis,202536,100318,102218,kreis,Baden-Württemberg
08237,Freudenstadt,121164,60561,60603,kreis,Baden-Württemberg
083,Freiburg,2322689,1143714,1178975,regierungsbezirk,Baden-Württemberg
08311,FreiburgimBreisgau,236140,112382,123758,kreis,Baden-Württemberg
08315,Breisgau-Hochschwarzwald,269948,132897,137051,kreis,Baden-Württemberg
08316,Emmendingen,170996,84495,86501,kreis,Baden-Württemberg
08317,Ortenaukreis,441885,220341,221544,kreis,Baden-Württemberg
08325,Rottweil,142593,71335,71258,kreis,Baden-Württemberg
08326,Schwarzwald-Baar-Kreis,217181,107434,109747,kreis,Baden-Württemberg
08327,Tuttlingen,144891,72930,71961,kreis,Baden-Württemberg
08335,Konstanz,292568,141939,150629,kreis,Baden-Württemberg
08336,Lörrach,233027,114220,118807,kreis,Baden-Württemberg
08337,Waldshut,173460,85741,87719,kreis,Baden-Württemberg
084,Tübingen,1903319,944459,958860,regierungsbezirk,Baden-Württemberg
08415,Reutlingen,291696,144375,147321,kreis,Baden-Württemberg
08416,Tübingen,232803,113022,119781,kreis,Baden-Württemberg
08417,Zollernalbkreis,193235,95712,97523,kreis,Baden-Württemberg
08421,Ulm,128928,63803,65125,kreis,Baden-Württemberg
08425,Alb-Donau-Kreis,202476,101989,100487,kreis,Baden-Württemberg
08426,Biberach,206513,104027,102486,kreis,Baden-Württemberg
08435,Bodenseekreis,222712,109351,113361,kreis,Baden-Württemberg
08436,Ravensburg,290911,144799,146112,kreis,Baden-Württemberg
08437,Sigmaringen,134045,67381,66664,kreis,Baden-Württemberg
09,Bayern,13369393,6620203,6749190,bundesland,Bayern
091,Oberbayern,4801769,2370431,2431338,regierungsbezirk,Bayern
09161,Ingolstadt,141029,71308,69721,kreis,Bayern
09162,München,1512491,736806,775685,kreis,Bayern
09163,Rosenheim,64403,31922,32481,kreis,Bayern
09171,Altötting,113798,56238,57560,kreis,Bayern
09172,BerchtesgadenerLand,107667,52850,54817,kreis,Bayern
09173,BadTölz-Wolfratshausen,129511,63758,65753,kreis,Bayern
09174,Dachau,156982,78276,78706,kreis,Bayern
09175,Ebersberg,146830,73169,73661,kreis,Bayern
09176,Eichstätt,135591,68634,66957,kreis,Bayern
09177,Erding,141680,71117,70563,kreis,Bayern
09178,Freising,184433,94031,90402,kreis,Bayern
09179,Fürstenfeldbruck,221612,108617,112995,kreis,Bayern
09180,Garmisch-Partenkirchen,88840,42925,45915,kreis,Bayern
09181,LandsbergamLech,123032,61199,61833,kreis,Bayern
09182,Miesbach,101346,49603,51743,kreis,Bayern
09183,Mühldorfa.Inn,119878,60544,59334,kreis,Bayern
09184,München,355890,176060,179830,kreis,Bayern
09185,Neuburg-Schrobenhausen,99957,50240,49717,kreis,Bayern
09186,Pfaffenhofena.d.Ilm,132082,67028,65054,kreis,Bayern
09187,Rosenheim,266945,131878,135067,kreis,Bayern
09188,Starnberg,138785,66902,71883,kreis,Bayern
09189,Traunstein,180779,89067,91712,kreis,Bayern
09190,Weilheim-Schongau,138208,68259,69949,kreis,Bayern
092,Niederbayern,1273955,637936,636019,regierungsbezirk,Bayern
09261,Landshut,75457,36833,38624,kreis,Bayern
09262,Passau,53907,26167,27740,kreis,Bayern
09263,Straubing,49164,24797,24367,kreis,Bayern
09271,Deggendorf,122121,61353,60768,kreis,Bayern
09272,Freyung-Grafenau,79286,39459,39827,kreis,Bayern
09273,Kelheim,125701,63520,62181,kreis,Bayern
09274,Landshut,164773,83050,81723,kreis,Bayern
09275,Passau,196963,97778,99185,kreis,Bayern
09276,Regen,78035,38968,39067,kreis,Bayern
09277,Rottal-Inn,124436,62503,61933,kreis,Bayern
09278,Straubing-Bogen,103806,52035,51771,kreis,Bayern
09279,Dingolfing-Landau,100306,51473,48833,kreis,Bayern
093,Oberpfalz,1133741,564751,568990,regierungsbezirk,Bayern
09361,Amberg,42534,20920,21614,kreis,Bayern
09362,Regensburg,157443,76690,80753,kreis,Bayern
09363,Weideni.d.OPf.,43052,20833,22219,kreis,Bayern
09371,Amberg-Sulzbach,104436,52328,52108,kreis,Bayern
09372,Cham,130193,65441,64752,kreis,Bayern
09373,Neumarkti.d.OPf.,138086,69843,68243,kreis,Bayern
09374,Neustadta.d.Waldnaab,95954,47697,48257,kreis,Bayern
09375,Regensburg,198160,99038,99122,kreis,Bayern
09376,Schwandorf,151711,76171,75540,kreis,Bayern
09377,Tirschenreuth,72172,35790,36382,kreis,Bayern
094,Oberfranken,1073783,529160,544623,regierungsbezirk,Bayern
09461,Bamberg,79935,39117,40818,kreis,Bayern
09462,Bayreuth,74506,36399,38107,kreis,Bayern
09463,Coburg,41842,20328,21514,kreis,Bayern
09464,Hof,46656,22663,23993,kreis,Bayern
09471,Bamberg,149122,74606,74516,kreis,Bayern
09472,Bayreuth,104702,51923,52779,kreis,Bayern
09473,Coburg,87103,43107,43996,kreis,Bayern
09474,Forchheim,117948,58401,59547,kreis,Bayern
09475,Hof,94589,46307,48282,kreis,Bayern
09476,Kronach,66393,32798,33595,kreis,Bayern
09477,Kulmbach,71653,35199,36454,kreis,Bayern
09478,Lichtenfels,67328,33189,34139,kreis,Bayern
09479,Wunsiedeli.Fichtelgebirge,72006,35123,36883,kreis,Bayern
095,Mittelfranken,1805791,889544,916247,regierungsbezirk,Bayern
09561,Ansbach,42221,20194,22027,kreis,Bayern
09562,Erlangen,116562,57940,58622,kreis,Bayern
09563,Fürth,131433,64348,67085,kreis,Bayern
09564,Nürnberg,523026,255250,267776,kreis,Bayern
09565,Schwabach,41227,20110,21117,kreis,Bayern
09571,Ansbach,188623,94550,94073,kreis,Bayern
09572,Erlangen-Höchstadt,140994,69977,71017,kreis,Bayern
09573,Fürth,119923,58382,61541,kreis,Bayern
09574,NürnbergerLand,172665,84864,87801,kreis,Bayern
09575,Neustadta.d.Aisch-BadWindsheim,103303,51799,51504,kreis,Bayern
09576,Roth,128694,63723,64971,kreis,Bayern
09577,Weißenburg-Gunzenhausen,97120,48407,48713,kreis,Bayern
096,Unterfranken,1334376,660476,673900,regierungsbezirk,Bayern
09661,Aschaffenburg,72444,35160,37284,kreis,Bayern
09662,Schweinfurt,54675,27041,27634,kreis,Bayern
09663,Würzburg,127810,61008,66802,kreis,Bayern
09671,Aschaffenburg,176958,87610,89348,kreis,Bayern
09672,BadKissingen,104567,51477,53090,kreis,Bayern
09673,Rhön-Grabfeld,80341,39954,40387,kreis,Bayern
09674,Haßberge,84984,42626,42358,kreis,Bayern
09675,Kitzingen,93247,46806,46441,kreis,Bayern
09676,Miltenberg,129835,64503,65332,kreis,Bayern
09677,Main-Spessart,127132,63281,63851,kreis,Bayern
09678,Schweinfurt,117044,59107,57937,kreis,Bayern
09679,Würzburg,165339,81903,83436,kreis,Bayern
097,Schwaben,1945978,967905,978073,regierungsbezirk,Bayern
09761,Augsburg,301033,148355,152678,kreis,Bayern
09762,Kaufbeuren,45792,22583,23209,kreis,Bayern
09763,Kempten(Allgäu),70056,34669,35387,kreis,Bayern
09764,Memmingen,45857,22647,23210,kreis,Bayern
09771,Aichach-Friedberg,137334,68380,68954,kreis,Bayern
09772,Augsburg,261342,129390,131952,kreis,Bayern
09773,Dillingena.d.Donau,99109,49626,49483,kreis,Bayern
09774,Günzburg,130112,65595,64517,kreis,Bayern
09775,Neu-Ulm,180425,89639,90786,kreis,Bayern
09776,Lindau(Bodensee),83393,41121,42272,kreis,Bayern
09777,Ostallgäu,145378,72362,73016,kreis,Bayern
09778,Unterallgäu,150068,75833,74235,kreis,Bayern
09779,Donau-Ries,137137,69586,67551,kreis,Bayern
09780,Oberallgäu,158942,78119,80823,kreis,Bayern
10,Saarland,992666,487101,505565,bundesland,Saarland
10041,Saarbrücken,330848,162630,168218,regionalverband,Saarland
10041100,Saarbrücken,181959,90445,91514,landeshauptstadt,Saarland
10042,Merzig-Wadern,104425,51552,52873,kreis,Saarland
10043,Neunkirchen,132283,65064,67219,kreis,Saarland
10044,Saarlouis,195749,95910,99839,kreis,Saarland
10045,Saarpfalz-Kreis,142419,69192,73227,kreis,Saarland
10046,St.Wendel,86942,42753,44189,kreis,Saarland
11,Berlin,3755251,1843196,1912055,bundesland,Berlin
12,Brandenburg,2573135,1265151,1307984,bundesland,Brandenburg
12051,BrandenburganderHavel,73609,36106,37503,kreis,Brandenburg
12052,Cottbus,99515,48535,50980,kreis,Brandenburg
12053,Frankfurt(Oder),58230,28223,30007,kreis,Brandenburg
12054,Potsdam,185750,89442,96308,kreis,Brandenburg
12060,Barnim,191849,94508,97341,kreis,Brandenburg
12061,Dahme-Spreewald,178967,88512,90455,kreis,Brandenburg
12062,Elbe-Elster,100902,50011,50891,kreis,Brandenburg
12063,Havelland,169334,83473,85861,kreis,Brandenburg
12064,Märkisch-Oderland,200292,99079,101213,kreis,Brandenburg
12065,Oberhavel,218551,107236,111315,kreis,Brandenburg
12066,Oberspreewald-Lausitz,108263,53007,55256,kreis,Brandenburg
12067,Oder-Spree,182401,89338,93063,kreis,Brandenburg
12068,Ostprignitz-Ruppin,99871,49583,50288,kreis,Brandenburg
12069,Potsdam-Mittelmark,222570,109781,112789,kreis,Brandenburg
12070,Prignitz,76045,37625,38420,kreis,Brandenburg
12071,Spree-Neiße,112493,55072,57421,kreis,Brandenburg
12072,Teltow-Fläming,176648,88122,88526,kreis,Brandenburg
12073,Uckermark,117845,57498,60347,kreis,Brandenburg
13,Mecklenburg-Vorpommern,1628378,799695,828683,bundesland,Mecklenburg-Vorpommern
13003,Rostock,209920,102800,107120,kreis,Mecklenburg-Vorpommern
13004,Schwerin,98596,47203,51393,kreis,Mecklenburg-Vorpommern
13071,MecklenburgischeSeenplatte,259568,127218,132350,kreis,Mecklenburg-Vorpommern
13072,LandkreisRostock,220807,109406,111401,kreis,Mecklenburg-Vorpommern
13073,Vorpommern-Rügen,227683,111156,116527,kreis,Mecklenburg-Vorpommern
13074,Nordwestmecklenburg,160288,79473,80815,kreis,Mecklenburg-Vorpommern
13075,Vorpommern-Greifswald,237355,115725,121630,kreis,Mecklenburg-Vorpommern
13076,Ludwigslust-Parchim,214161,106714,107447,kreis,Mecklenburg-Vorpommern
14,Sachsen,4086152,2010537,2075615,bundesland,Sachsen
145,Chemnitz,1411556,693193,718363,statistischeregion,Sachsen
14511,Chemnitz,248563,122678,125885,kreis,Sachsen
14521,Erzgebirgskreis,328850,160991,167859,kreis,Sachsen
14522,Mittelsachsen,300639,149223,151416,kreis,Sachsen
14523,Vogtlandkreis,222666,108488,114178,kreis,Sachsen
14524,Zwickau,310838,151813,159025,kreis,Sachsen
146,Dresden,1598250,788007,810243,statistischeregion,Sachsen
14612,Dresden,563311,279338,283973,kreis,Sachsen
14625,Bautzen,297711,146982,150729,kreis,Sachsen
14626,Görlitz,249681,122032,127649,kreis,Sachsen
14627,Meißen,241343,118391,122952,kreis,Sachsen
14628,SächsischeSchweiz-Osterzgebirge,246204,121264,124940,kreis,Sachsen
147,Leipzig,1076346,529337,547009,statistischeregion,Sachsen
14713,Leipzig,616093,302741,313352,kreis,Sachsen
14729,Leipzig,260429,127570,132859,kreis,Sachsen
14730,Nordsachsen,199824,99026,100798,kreis,Sachsen
15,Sachsen-Anhalt,2186643,1073711,1112932,bundesland,Sachsen-Anhalt
15001,Dessau-Roßlau,79655,38509,41146,kreis,Sachsen-Anhalt
15002,Halle(Saale),242083,116835,125248,kreis,Sachsen-Anhalt
15003,Magdeburg,239364,117729,121635,kreis,Sachsen-Anhalt
15081,AltmarkkreisSalzwedel,82457,41042,41415,kreis,Sachsen-Anhalt
15082,Anhalt-Bitterfeld,157235,76971,80264,kreis,Sachsen-Anhalt
15083,Börde,171393,85383,86010,kreis,Sachsen-Anhalt
15084,Burgenlandkreis,177212,87200,90012,kreis,Sachsen-Anhalt
15085,Harz,210381,103454,106927,kreis,Sachsen-Anhalt
15086,JerichowerLand,90256,44854,45402,kreis,Sachsen-Anhalt
15087,Mansfeld-Südharz,132034,64916,67118,kreis,Sachsen-Anhalt
15088,Saalekreis,183974,90866,93108,kreis,Sachsen-Anhalt
15089,Salzlandkreis,186420,90887,95533,kreis,Sachsen-Anhalt
15090,Stendal,110291,54172,56119,kreis,Sachsen-Anhalt
15091,Wittenberg,123888,60893,62995,kreis,Sachsen-Anhalt
16,Thüringen,2126846,1051482,1075364,bundesland,Thüringen
16051,Erfurt,214969,104205,110764,kreis,Thüringen
16052,Gera,93634,45174,48460,kreis,Thüringen
16053,Jena,111191,55301,55890,kreis,Thüringen
16054,Suhl,37009,18339,18670,kreis,Thüringen
16055,Weimar,65620,31624,33996,kreis,Thüringen
16061,Eichsfeld,100091,50150,49941,kreis,Thüringen
16062,Nordhausen,82444,40782,41662,kreis,Thüringen
16063,Wartburgkreis,159539,79425,80114,kreis,Thüringen
16064,Unstrut-Hainich-Kreis,102256,50688,51568,kreis,Thüringen
16065,Kyffhäuserkreis,73690,36612,37078,kreis,Thüringen
16066,Schmalkalden-Meiningen,123939,61977,61962,kreis,Thüringen
16067,Gotha,134941,66997,67944,kreis,Thüringen
16068,Sömmerda,69646,34846,34800,kreis,Thüringen
16069,Hildburghausen,61926,31002,30924,kreis,Thüringen
16070,Ilm-Kreis,106776,53798,52978,kreis,Thüringen
16071,WeimarerLand,83179,41156,42023,kreis,Thüringen
16072,Sonneberg,56922,28093,28829,kreis,Thüringen
16073,Saalfeld-Rudolstadt,101494,49926,51568,kreis,Thüringen
16074,Saale-Holzland-Kreis,83234,41328,41906,kreis,Thüringen
16075,Saale-Orla-Kreis,79178,39306,39872,kreis,Thüringen
16076,Greiz,96381,47487,48894,kreis,Thüringen
16077,AltenburgerLand,88787,43266,45521,kreis,Thüringen
